EMBOSS_005	TGTGCGGTACATAAGATATCAAAGTACCCAAAATATGTATAATATACTGTACATAAATTATGAAAGTACACATT----TATAATAAACTGTACATAAAATA----
EMBOSS_070	TGTGCGGTACATAAGATATCAAAGTACCCAAAATATGTATAATATACTGTACATAAATTATGAAAGTACACATT----TATAATAAACTGTACATAAAATAACAA
EMBOSS_040	TGTGCGGTACATAAGATATCAAAGTACCCAAAATATGTATAATATACTGTACATAATTTATGAAAGTACCCATT----TATAATAAACTGTATA-----------
EMBOSS_060	TGTGCGGTACATAAGATATCACAGTACCCAAAATATTTATTATATAATGTACATAAAATATGAAAGTAAGCAAACATTTATAATAAACTGT--------------
EMBOSS_061	TGTGCGGTACATAAGATATCAAAGAACCCAAAATATGTATTATATAATGTACATAAAATATGAAAGTAAGCAAACATTTATAATAAACTGT--------------
EMBOSS_004	TGTGCGGTACATAAGATATCAAAGTGCCCAAAGTATGTATTATATACTGTACATAAAATATGAAAGTACCAAAACATTTATAATAAAGTGTACATAAAA------
EMBOSS_022	TGTGCGGTACATAAGATATCAAAGTGCCCAAAGTATGTATTATATACTGTACATAAAATATGAAAGTACCAAAACATTTATAATAAAGTGTACATA---------
EMBOSS_052	TGTGCGGTACATAAGATATCAAAGTGCCCAAAGTATGTATTATATACTGTACATAAAATATGAAAGTACCAAAACATTTATAATAAAGTGTACATAAAAC-----
EMBOSS_014	TGTGCGGTACATAAGATATCAAAGTACCAAAAACATGTGTTATATACTGTACATAAAATATGAAAGTAACCAAATATTAATAATAAAT-----------------
EMBOSS_023	TGTGCGGTACATAAGATATCAAAGTACCAAAAACATGTGTTATATACTGTACATAAAATATGAAAGTAACCAAATATTAATAATAAATTG---------------
EMBOSS_034	TGTGCGGTACATAAGATATCAAAGTACCCAAAATATGCATTATATACTATACAAAAAATATGAAAGTAACAAAACATTTATAATAAACTGTA-------------
EMBOSS_069	TGTGCGGTACATAAGATATCAAAGTACACAAAATATGTATTATATACTGTACATAAAATGTGAAAGTAACCAAACATTTACAATAAACTGTACA-----------
EMBOSS_019	TGTGCGGTACATAAGATATCAAAGTACACAAAATATGTATTATATACTGTACATAAAATGTGAAAGTAACCAAACATTTATAATAAACTGT--------------
EMBOSS_043	TGTGCGGTACATAAGATATCAAAGTCCACAAAATATGTATTATATACTGTACATAAAATGTGAAAGTAACCAAACATTTATAATAAACTGTA-------------
EMBOSS_068	TGTGCGGTACATAAGATATCAAAGTACCCAAAATATGTATTATTTACTGTGCATAAAATATGAAAGTAAGCAAACATTTATAATAAACTGTAC------------
EMBOSS_031	TGTGCGGTACATAAGATATCAAAGTACCCAAAATATGTATTATTTACTGTGCATAAAATATGAAAGTAACCAAACATTTATAATAAACTGT--------------
EMBOSS_036	TGTGCGGTACATAAGATATCAAAGTACCCAAAATATGTATTATTTACTGTGCATAAAATATGAAAGTAACCAAACATTTATAATAAACTGTACATAAAATATC--
EMBOSS_038	TGTGCGGTACATAAGATATCAAAGTACCCAAAATATGTATTATTTACTGTGCATAAAATATGAAAGTAACCAAACATTTATAATAAACTGTACATAAAATAT---
EMBOSS_046	TGTGCGGTACATAAGATATCAAAGTACCCAAAATATGTATTATTTACTGTGCATAAAATATGAAAGTAACCAAACATTTATAATAAACTGTA-------------
EMBOSS_048	TGTGCGGTACATAAGATATCAAAGTACCCAAAATATGTATTATTTACTGTGCATAAAATATGAAAGTAACCAAACATTTATAATAAACTG---------------
EMBOSS_059	TGTGCGGTACATAAGATATCAAAGTACCCAAAATATGTATTATTTACTGTGCATAAAATATGAAAGTAACCAAACATTTATAATAAACTGTACATAAAAT-----
EMBOSS_074	TGTGCGGTACATAAGATATCAAAGTACCCAAAATATGTATTATTTACTGTGCATAAAATATGAAAGTAACCAAACATTTATAATAAACTGTAC------------
EMBOSS_020	TGTGCGGTACATAAGATATCAAAGTACCCAAAATATGTATTATTTACTGTACATAATATATAAAACTAACCAAACATTTA-------------------------
EMBOSS_076	TGTGCGGTACATAAGATATCAAAGTACTCAAAATATGTATTATATACTGTACATAAAATATGAAAGTAACCAAACATTTATAATAACC-----------------
EMBOSS_028	TGTGCGGTACATAAGATATCAAAATACCAAAAATATGTATTATATACTGTACATAAAACATGAAAGTAACCAAACATTTATAATAAACT----------------
EMBOSS_050	TGTGCGGTACATAAGATATCAAAATACCAAAAATATGTATTATATACTGTACATAAAACATGAAAGTAACCAAACATTTATAATAAACTGTA-------------
EMBOSS_002	TGTGCGGTACATAAGATATCAAAGAACCCAAAATATGTATTATATACTGTACATAAAAGATGAAAGTAACCAAACATTTATAATAAACTG---------------
EMBOSS_015	TGTGCGGTACATAAGATATCAAAGAACCCAAAATATGTATTATATACTGTACATAAAAGATGAAAGTAACCAAACATTTATAATAAACTGT--------------
EMBOSS_030	TGTGCGGTACATAAGATATCAAAGAACCCAAAATATGTATTATATACTGTACATAAAAGATGAAAGTAACCAAACATTTATAATAAAC-----------------
EMBOSS_051	TGTGCGGTACATAAGATATCAAAGAACCCAAAATATGTATTATATACTGTACATAAAAGATGAAAGTAACCAAACATTTATAATAAACTGTA-------------
EMBOSS_063	TGTGCGGTACATAAGATATCAAAGAACCCAAAATATGTATTATATACTGTACATAAAAGATGAAAGTAACCAAACATTTATAATAAACTGTAC------------
EMBOSS_008	TGTGCGGTACATAAGATATCAAAGTACCCAAAATATGTATTATTTACTGTACATAATATATGAAAGTAACCAAACATTTATAATAAACTGTA-------------
EMBOSS_006	TGTGCGGTACATAAGATATCAAAGTACTCAAAATATGTATTATATACTGTACATAAAATATGAAAGTAACCAAACATTTATAATAAACTGTA-------------
EMBOSS_062	TGTGCGGTACATAAGATATCAAAGTACTCAAAATATGTATTATATACTGTACATAAAATATGAAAGTAACCAAACATTTATAATAAACTGTACA-----------
EMBOSS_067	TGTGCGGTACATAAGATATCAAAGTACTCAAAATATGTATTATATACTGTACATAAAATATGAAAGTAACCAAACATTTATAATAAAC-----------------
EMBOSS_016	TGTGCGGTACATAAGATATCAAAGTACCCAAAATATGTATTATATACTGTACATAAAATACGAAAGTAACCAAACATTTATAATAAACTGT--------------
EMBOSS_056	TGTGCGGTACATAAGATATCAAAGTACCCAAAATATGTATTATATACTGTACATAAAATACGAAAGTAACCAAACATTTATAATAAACTGTAC------------
EMBOSS_075	TGTGCGGTACATAAGATATCAAAGTACCCAAAATATGTATTATATACTGTACATAAAACATGAAAGTAACCAAACATTTATAATAAACTGTA-------------
EMBOSS_072	TGTGCGGTACATAAGATATCAAAGTACCAAAAATATGTATTATATACTGTACATAAAATATGAAAGTAACCAAACATTTATAATAAACTGTACATAAAAT-----
EMBOSS_053	TGTGCGGTACATAAGATATCAAAGTACCCAAAATATGTATTATATACTGTACATAAAATATGAAAGAAACCAAACATTTATAATAAACTGTA-------------
EMBOSS_047	TGTGCGGTACATAAGATATCAAAGTACCCAAAATATGTATTATATACTGAACATAAAATATGAAAGTAACCAAACATTTATAATAAACTGTA-------------
EMBOSS_012	TGTGCGGTACATAAGATATCAAAGTACCCAAAATATGTATTATATACTGTACATAAAATATGAAAGTAACCAAACATTTATAATAAACTGT--------------
EMBOSS_021	TGTGCGGTACATAAGATATCAAAGTACCCAAAATATGTATTATATACTGTACATAAAATATGAAAGTAACCAAACATTTATAATAAACTGTA-------------
EMBOSS_049	TGTGCGGTACATAAGATATCAAAGTTCCCAAAATATGTATTATATACTGTACATAAAATATGAAAGTACCCAACCCTTTATAATAAACTCT--------------
EMBOSS_010	TGTGCGGTACATAAGATATCAAAGTTCCCAAAATATGTATTATATACTGTACATAAAATATGAAAGTACCCAACCATTTATAATAAACTCTAC------------
EMBOSS_039	TGTGCGGTACATAAGATATCAAAGTTCCCAAAATATGTATTATATACTGTACATAAAATATGAAAGTACCCAACCATTTATAATAAACTCTACATAAAA------
EMBOSS_071	TGTGCGGTACATAAGATATCAAAGTTCCCAAAATATGTATTATATACTGTACATAAAATATGAAAGTACCCAACCATTTATAATAAACTCTA-------------
EMBOSS_057	TGTGCGGTACATAAGATATCAAAGTTCCCAAAATATGTATTATATACTGTAAATAAAATATGAAAGTACCCAACCATTTATAATAAACTCTA-------------
EMBOSS_026	TGTGCGGTACATAAGATATCAAAGTACCCAATATATGTATAATATACTGTACATAAAATTTGAAAGTACCCAAGCATTTATAAAAAACTGTA-------------
EMBOSS_037	TGTGCGGTACATAAGATATCAAAGTACCCAAAATATGTATAATATACTGTACATAAATTATGTATGTAACCAAACATTTATAATAAACTGTACA-----------
EMBOSS_044	TGTGCGGTACATAAGATATCAAAGTACCCAAAATATGTATAATATACTGTACATAAATTATGTATGTAACCAAACATTTATAATAAACTGTAC------------
EMBOSS_009	TGTGCGGTACATAAGATATCAAAGTACGCAAAATATGTGTAATATACTGTATATAAATTATGAAAGTACCCAAACATTTATAATAAGCTG---------------
EMBOSS_024	TGTGCGGTACATAAGATATCAAAGTACGCAAAATATGTGTAATATACTGTATATAAATTATGAAAGTACCCAAACATTTATAATAAGCTGT--------------
EMBOSS_045	TGTGCGGTACATAAGATATCAAAGTACCCAAAATATGTATAATATACTGTACATAAATTATTAAAGTACACAAACATTTATAATAAACTGTA-------------
EMBOSS_055	TGTGCGGTACATAAGATATCAAAGTACCCAAAATATGTATAATATACTGTATATAAATTATGAAAGTACCCAAACCTTTATAATAAACTGTACA-----------
EMBOSS_001	TGTGCGGTACATAAGATATCAAAGTACCAAAAATATGTATAATATACTGTATATAAATTATGAAAGTACCCAAACCTTTATAATAAACTGTA-------------
EMBOSS_007	TGTGCGGTACATAAGATATCAAAGTACCAAAAATATGTATAATATACTGTATATAAATTATGAAAGTACCCAAACCTTTATAATAAACTGTAC------------
EMBOSS_029	TGTGCGGTACATAAGATATCAAAGTACCCAAAATATGTATAATATACTGTACATAAATTATGAAACTACCCAAACATTTATAATAAACTGTACATAAAA------
EMBOSS_054	TGTGCGGTACATAAGATATCAAAGTACCCAAAATATGTATAATATACTGTACATAAATTATGAAACTACCCAAACATTTATAATAAACTGTACATAAAAT-----
EMBOSS_017	TGTGCGGTACATAAGATATCAAAGTACCCAATATATGTATAATATACTGTACATAAATTATGAAAGTACCGAAGCATTTATAATAAACTGTACATAAA-------
EMBOSS_033	TGTGCGGTACATAAGATATCAAAGTACCCAAAATATGTATAATATACTGTACATAAATTATGAAAGTACCCAAGCATTTATAATAAACTGTACAAA---------
EMBOSS_032	TGTGCGGTACATAAGATATCAAAGTACCCAAAATATGTATAATATACTGTACATAAATTATGAAAGTACCCAAGCATTTATAATAAACTGTACATAAAAC-----
EMBOSS_003	TGTGCGGTACATAAGATATCAAAGTACCCAAAATATGTATAATATACTGTACATAAATTATGAAAGTACCCAAGCATTTATAATAAACTGTACATAAAATA----
EMBOSS_011	TGTGCGGTACATAAGATATCAAAGTACCCAAAATATGTATAATATACTGTACATAAATTATGAAAGTACCCAAGCATTTATAATAAACTGTACA-----------
EMBOSS_025	TGTGCGGTACATAAGATATCAAAGTACCCAAAATATGTATAATATACTGTACATAAATTATGAAAGTACCCAAGCATTTATAATAAACTGTACATAAAATAAC--
EMBOSS_027	TGTGCGGTACATAAGATATCAAAGTACCCAAAATATGTATAATATACTGTACATAAATTATGAAAGTACCCAAGCATTTATAATAAACTGTACATAAAAT-----
EMBOSS_035	TGTGCGGTACATAAGATATCAAAGTACCCAAAATATGTATAATATACTGTACATAAATTATGAAAGTACCCAAGCATTTATAATAAACTGTACATAA--------
EMBOSS_041	TGTGCGGTACATAAGATATCAAAGTACCCAAAATATGTATAATATACTGTACATAAATTATGAAAGTACCCAAGCATTTATAATAAACTGTACATAAAA------
EMBOSS_058	TGTGCGGTACATAAGATATCAAAGTACCCAAAATATGTATAATATACTGTACATAAATTATGAAAGTACCCAAGCATTTATAATAAACTGTACATAAAATAA---
EMBOSS_066	TGTGCGGTACATAAGATATCAAAGTACCCAAAATATGTATAATATACTGTACATAAATTATGAAAGTACCCAAGCATTTATAATAAACTGTAC------------
EMBOSS_065	TGTGCGGTACATAAGATATCAAAGTACCCAAAATATGTATAATATGCTGTACAAAAATTATGAAAGTACCCAAACATTTATAATAAACTGT--------------
EMBOSS_073	TGTGCGGTACATAAGATATCAAAGTACCCAAAATATGTATAATATGCTGTACAAAAATTATGAAAGTACCCAAACATTTATAATAAACTGTACATAAAATAA---
EMBOSS_013	TGTGCGGTACATAAGATATCAAAGTACCCAAAATATGTATAATATTCTGTACATAAATTATGAAAGTACCCAAACATTTATAATAAACTGTATATAAAAC-----
EMBOSS_018	TGTGCGGTACATAAGATATCAAAGTACCCAAAATATGTATAATATTCTGTACATAAATTATGAAAGTACCCAAACATTTATAATAAACTGTATATAAAA------
EMBOSS_042	TGTGCGGTACATAAGATATCAAAGTACCCAAAATATGTATAATATTCTGTACATAAATTATGAAAGTACCCAAACATTTATAATAAACTGTATATAAA-------
EMBOSS_064	TGTGCGGTACATAAGATATCAAAGTACCCAAAATATGTATAATATACTGTAAATAAATTATGAAAGTACCCAAACATTTATAATAAACTGT--------------                      
